13x12
*************
*  **       1
*     *******
*        ****
**          *
*     **** **
********** **
*           *
*    ********
*        *  *
********    *
*********2***
