39x15
******************1********************
**       *********              *******
******************************* ****  *
**********      *****    ******    ****
**    **************************** ****
********* ***  ****                ****
********* ********* *****     *********
**    ***       *** *******************
*************** ***          ****    **
****** ******** ************         **
**       ******          *********** **
************************             **
***************           *************
****             *************   ******
**********2****************************
