46x27
*****2****************************************
*****                   **************     ***
***** ******                   ***************
***** *************       ***********    *****
*****       *************   ******************
*********** *************      ******    *****
*********** ****************** ***************
*********** ******************       *********
***********                ********       ****
************************** **********     ****
************************** *************  ****
**************************        ******   ***
*****         ******************* ************
************************          *****    ***
************************ *********************
************************ *****  **************
************************ *********************
***      ******   ****** ************   ******
***********  *********** *********************
***********  ******  *** ***********    ******
****       *************     *****************
*******          ***  ****** *****************
**************************** *****  **********
*****                        ****  ***********
*  ** ***************************  ***********
*****                             ************
*********************************1************
