46x27
*****1****************************************
***** ****************************************
***** ****************************************
***** ****************************************
*****       ************           ***********
*********** **********************        ****
******      ***** *********           ********
**      *** * *** ****************************
***********     **********  ******************
******                     ***** *************
************************** *******************
******            ********        ************
********************************* ************
************************          ************
*****         ********** ******** ************
***********              *********************
************************ *********************
********          ******                ******
****            ******** *********************
*********   ************ *********************
*******          *******     **********      *
***     ******************** *****************
*******           ********** *****************
*****                        *******      ****
***** *****         **       *       *********
*****       **********            ************
*********************************2************
