37x15
*************1***********************
*                                   *
*********************************** *
*                                   *
* ***********************************
*                                   *
*********************************** *
*                                   *
* ***********************************
*                                   *
*********************************** *
*                                   *
* ***********************************
*                                   *
**********************2**************
